2 3 2 3 2 2 4
1 0 0 1 0 0 4
3 2 4 3 2 2 3
2 4 2 4 2 4 4
2 2 2 2 3 2 4
