2 3 2 3 2 2 4
2 2 0 2 3 0 4
2 4 2 4 2 4 4
2 2 2 2 2 2 4
4 4 4 4 4 4 4